Date,Project ID,Name,Points,Historical Download,Daily Download,Daily Unique Download,Daily Twitch App Download,Daily Curse Forge Download
2019-08-22,336883,JANOEO,0,21,21,20,3,18
2019-08-23,336883,JANOEO,0,75,54,51,10,44
2019-08-24,336883,JANOEO,0,103,28,28,3,25
2019-08-25,336883,JANOEO,0,130,27,20,2,25
2019-08-26,336883,JANOEO,0.08,154,24,24,5,19
2019-08-27,336883,JANOEO,0.09,190,36,31,14,22
2019-08-28,336883,JANOEO,0.1,236,46,41,14,32
2019-08-29,336883,JANOEO,0.12,259,23,18,7,16
2019-08-30,336883,JANOEO,0.13,278,19,18,9,10
2019-08-31,336883,JANOEO,0.13,332,54,41,16,38
2019-09-01,336883,JANOEO,0.23,419,87,72,27,60
2019-09-02,336883,JANOEO,0.26,479,60,49,10,50
2019-09-03,336883,JANOEO,0.28,498,19,15,1,18
2019-09-04,336883,JANOEO,0.28,525,27,23,4,23
2019-09-05,336883,JANOEO,0.29,539,14,13,4,10
2019-09-06,336883,JANOEO,0.3,557,18,17,2,16
2019-09-07,336883,JANOEO,0.3,571,14,14,1,13
2019-09-08,336883,JANOEO,0.31,596,25,22,3,22
2019-09-09,336883,JANOEO,0.32,610,14,12,3,11
2019-09-10,336883,JANOEO,0.32,623,13,12,0,13
2019-09-11,336883,JANOEO,0.33,639,16,16,1,15
2019-09-12,336883,JANOEO,0.33,652,13,13,0,13
2019-09-13,336883,JANOEO,0,677,25,24,11,14
2019-09-14,336883,JANOEO,0.37,698,21,18,3,18
2019-09-15,336883,JANOEO,0.37,711,13,13,1,12
2019-09-16,336883,JANOEO,0.38,741,30,26,13,17
2019-09-17,336883,JANOEO,0.38,760,19,19,7,12
2019-09-18,336883,JANOEO,0.39,774,14,13,7,7
2019-09-19,336883,JANOEO,0.4,785,11,9,1,10
2019-09-20,336883,JANOEO,0.4,804,19,15,6,13
2019-09-21,336883,JANOEO,0.41,813,9,9,3,6
2019-09-22,336883,JANOEO,0.41,817,4,4,3,1
2019-09-23,336883,JANOEO,0.41,846,29,22,6,23
2019-09-24,336883,JANOEO,0.39,879,33,29,2,31
2019-09-25,336883,JANOEO,0.39,927,48,44,34,14
2019-09-26,336883,JANOEO,0.39,974,47,38,27,20
2019-09-27,336883,JANOEO,0.4,1003,29,24,16,13
2019-09-28,336883,JANOEO,0.39,1019,16,16,7,9
2019-09-29,336883,JANOEO,0.38,1023,4,4,2,2
2019-09-30,336883,JANOEO,0.38,1026,3,2,1,2
2019-10-01,336883,JANOEO,0.44,1040,14,14,7,7
2019-10-02,336883,JANOEO,0.43,1060,20,18,5,15
2019-10-03,336883,JANOEO,0.42,1128,68,59,45,23
2019-10-04,336883,JANOEO,0.41,1159,31,29,10,21
2019-10-05,336883,JANOEO,0.41,1189,30,24,9,21
2019-10-06,336883,JANOEO,0.4,1198,9,9,3,6
2019-10-07,336883,JANOEO,0.4,1228,30,28,17,13
2019-10-08,336883,JANOEO,0.4,1259,31,29,21,10
2019-10-09,336883,JANOEO,0.41,1275,16,14,8,8
2019-10-10,336883,JANOEO,0.4,1285,10,8,4,6
2019-10-11,336883,JANOEO,0.4,1292,7,6,5,2
2019-10-12,336883,JANOEO,0.39,1329,37,34,14,23
2019-10-13,336883,JANOEO,0.4,1361,32,31,14,18
2019-10-14,336883,JANOEO,0.4,1380,19,16,10,9
2019-10-15,336883,JANOEO,0.4,1394,14,14,8,6
2019-10-16,336883,JANOEO,0.4,1416,22,22,19,3
2019-10-17,336883,JANOEO,0.39,1434,18,17,5,13
2019-10-18,336883,JANOEO,0.4,1451,17,16,7,10
2019-10-19,336883,JANOEO,0.4,1470,19,15,7,12
2019-10-20,336883,JANOEO,0.4,1483,13,13,4,9
2019-10-21,336883,JANOEO,0.4,1499,16,14,1,15
2019-10-22,336883,JANOEO,0.4,1507,8,8,4,4
2019-10-23,336883,JANOEO,0.4,1512,5,5,2,3
2019-10-24,336883,JANOEO,0.4,1518,6,6,2,4
2019-10-25,336883,JANOEO,0.39,1526,8,7,2,6
2019-10-26,336883,JANOEO,0.39,1534,8,8,5,3
2019-10-27,336883,JANOEO,0.38,1550,16,10,3,13
2019-10-28,336883,JANOEO,0.39,1558,8,8,1,7
2019-10-29,336883,JANOEO,0.39,1586,28,24,8,20
2019-10-30,336883,JANOEO,0.39,1646,60,56,33,27
2019-10-31,336883,JANOEO,0.4,1707,61,50,36,25
2019-11-01,336883,JANOEO,0.4,1714,51,44,22,29
2019-11-02,336883,JANOEO,0.4,1743,29,21,14,15
2019-11-03,336883,JANOEO,0.4,1762,19,19,12,7
2019-11-04,336883,JANOEO,0.4,1779,17,17,8,9
2019-11-05,336883,JANOEO,0.4,1800,21,19,11,10
2019-11-06,336883,JANOEO,0.4,1843,43,40,13,30
2019-11-07,336883,JANOEO,0.41,1882,39,37,18,21
2019-11-08,336883,JANOEO,0.41,1919,37,36,18,19
2019-11-09,336883,JANOEO,0.41,1988,69,53,24,45
2019-11-10,336883,JANOEO,0.42,2013,25,25,7,18
2019-11-11,336883,JANOEO,0.42,2029,16,15,6,10
2019-11-12,336883,JANOEO,0.43,2067,38,35,30,8
2019-11-13,336883,JANOEO,0.43,2079,12,11,5,7
2019-11-14,336883,JANOEO,0.43,2095,16,13,8,8
2019-11-15,336883,JANOEO,0.43,2105,10,8,3,7
2019-11-16,336883,JANOEO,0.43,2123,18,17,7,11
2019-11-17,336883,JANOEO,0.43,2145,22,11,2,20
2019-11-18,336883,JANOEO,0.43,2157,12,9,1,11
2019-11-19,336883,JANOEO,0.42,2163,6,6,0,6
2019-11-20,336883,JANOEO,0.42,2172,9,9,4,5
2019-11-21,336883,JANOEO,0.42,2177,5,5,2,3
2019-11-22,336883,JANOEO,0.42,2187,10,8,5,5
2019-11-23,336883,JANOEO,0.43,2196,9,7,3,6
2019-11-24,336883,JANOEO,0.43,2206,10,9,5,5
2019-11-25,336883,JANOEO,0.43,2208,2,2,0,2
2019-11-26,336883,JANOEO,0.43,2236,28,27,24,4
2019-11-27,336883,JANOEO,0.43,2249,13,11,11,2
2019-11-28,336883,JANOEO,0.43,2271,22,22,7,15
2019-11-29,336883,JANOEO,0.43,2291,20,20,8,12
2019-11-30,336883,JANOEO,0.44,2310,19,19,6,13
2019-12-01,336883,JANOEO,0.38,2328,18,14,7,11
2019-12-02,336883,JANOEO,0.38,2344,16,11,3,13
2019-12-03,336883,JANOEO,0.38,2349,5,5,2,3
2019-12-04,336883,JANOEO,0.38,2361,12,12,6,6
2019-12-05,336883,JANOEO,0.37,2373,12,11,8,4
2019-12-06,336883,JANOEO,0.37,2385,12,12,8,4
2019-12-07,336883,JANOEO,0.37,2404,19,18,14,5
2019-12-08,336883,JANOEO,0.37,2422,18,15,8,10
2019-12-09,336883,JANOEO,0.36,2440,18,12,13,5
2019-12-10,336883,JANOEO,0.36,2469,29,22,26,3
2019-12-11,336883,JANOEO,0.35,2493,24,22,19,5
2019-12-12,336883,JANOEO,0.35,2587,94,91,92,2
2019-12-13,336883,JANOEO,0.35,3180,593,550,582,11
2019-12-14,336883,JANOEO,0.38,4027,847,794,836,11
2019-12-15,336883,JANOEO,0,4958,931,869,917,14
2019-12-16,336883,JANOEO,0.47,5746,788,710,764,24
2019-12-17,336883,JANOEO,0.5,6620,874,768,849,25
2019-12-18,336883,JANOEO,0.52,7256,636,577,626,10
2019-12-19,336883,JANOEO,0.53,7821,565,502,547,18
2019-12-20,336883,JANOEO,0.55,8444,623,563,588,35
2019-12-21,336883,JANOEO,0.56,9216,772,703,706,66
2019-12-22,336883,JANOEO,0.59,9924,708,650,625,83
2019-12-23,336883,JANOEO,0.63,10598,674,605,608,66
2019-12-24,336883,JANOEO,0,11170,572,537,536,36
2019-12-25,336883,JANOEO,0.77,11663,493,457,463,30
2019-12-26,336883,JANOEO,0.79,12335,672,600,635,37
2019-12-27,336883,JANOEO,0.82,13219,884,774,854,30
2019-12-28,336883,JANOEO,0.83,13953,734,640,674,60
2019-12-29,336883,JANOEO,0.86,14675,722,647,665,57
2019-12-30,336883,JANOEO,0,15462,787,718,711,76
2019-12-31,336883,JANOEO,1.8,16033,571,524,533,38
2020-01-01,336883,JANOEO,0.98,16995,962,837,912,50
2020-01-02,336883,JANOEO,1,17883,888,791,831,57
2020-01-03,336883,JANOEO,1.01,18673,790,716,743,47
2020-01-04,336883,JANOEO,1.03,19603,930,835,851,79
2020-01-05,336883,JANOEO,1.05,20576,973,861,878,95
2020-01-06,336883,JANOEO,1.07,21478,902,795,854,48
2020-01-07,336883,JANOEO,1.09,22476,998,879,915,83
2020-01-08,336883,JANOEO,1.11,23263,787,704,714,73
2020-01-09,336883,JANOEO,1.14,23888,625,546,546,79
2020-01-10,336883,JANOEO,1.16,24440,552,497,489,63
2020-01-11,336883,JANOEO,1.17,25238,798,710,715,83
2020-01-12,336883,JANOEO,1.19,25914,676,622,605,71
2020-01-13,336883,JANOEO,1.2,26460,546,491,485,61
2020-01-14,336883,JANOEO,1.21,27000,540,463,496,44
2020-01-15,336883,JANOEO,1.21,27702,702,590,637,65
2020-01-16,336883,JANOEO,1.2,28442,740,658,689,51
2020-01-17,336883,JANOEO,1.19,29121,679,599,645,34
2020-01-18,336883,JANOEO,0,30018,897,786,846,51
2020-01-19,336883,JANOEO,1.28,30939,921,798,861,60
2020-01-20,336883,JANOEO,1.28,31643,704,606,647,57
2020-01-21,336883,JANOEO,1.28,32320,677,578,631,46
2020-01-22,336883,JANOEO,0,32942,622,549,585,37
2020-01-23,336883,JANOEO,0,34439,1497,1283,1448,49
2020-01-24,336883,JANOEO,1.26,36005,1566,1321,1503,63
2020-01-25,336883,JANOEO,1.27,38493,2488,2041,2426,62
2020-01-26,336883,JANOEO,1.28,40667,2174,1874,2096,78
2020-01-27,336883,JANOEO,0,42270,1603,1356,1522,81
2020-01-28,336883,JANOEO,1.63,43720,1450,1226,1373,77
2020-01-29,336883,JANOEO,1.65,45121,1401,1217,1331,70
2020-01-30,336883,JANOEO,1.66,46502,1381,1168,1294,87
2020-01-31,336883,JANOEO,1.66,48123,1621,1403,1464,157
2020-02-01,336883,JANOEO,1.73,50282,2158,1899,2020,138
2020-02-02,336883,JANOEO,1.75,52482,2200,1915,2049,151
2020-02-03,336883,JANOEO,1.78,53938,1456,1242,1369,87
2020-02-04,336883,JANOEO,1.79,55481,1543,1346,1458,85
2020-02-05,336883,JANOEO,0,57057,1576,1386,1475,101
2020-02-06,336883,JANOEO,1.88,58609,1552,1324,1456,96
2020-02-07,336883,JANOEO,1.88,60703,2094,1763,1930,164
2020-02-08,336883,JANOEO,1.9,63321,2618,2220,2460,158
2020-02-09,336883,JANOEO,0,65845,2524,2117,2320,204
2020-02-10,336883,JANOEO,2.04,67427,1582,1400,1454,128
2020-02-11,336883,JANOEO,0,69441,2014,1736,1872,142
2020-02-12,336883,JANOEO,2.2,71306,1865,1565,1761,104
2020-02-13,336883,JANOEO,2.21,73399,2093,1782,1949,144
2020-02-14,336883,JANOEO,2.23,75507,2108,1803,1984,124
2020-02-15,336883,JANOEO,2.25,77990,2483,2093,2350,133
2020-02-16,336883,JANOEO,2.29,80527,2537,2104,2388,149
2020-02-17,336883,JANOEO,2.32,82471,1944,1631,1801,143
2020-02-18,336883,JANOEO,2.35,84072,1601,1366,1482,119
2020-02-19,336883,JANOEO,2.38,86006,1934,1653,1823,111
2020-02-20,336883,JANOEO,2.41,87727,1721,1481,1616,105
2020-02-21,336883,JANOEO,2.43,89676,1949,1627,1809,140
2020-02-22,336883,JANOEO,0,92094,2418,1983,2266,152
2020-02-23,336883,JANOEO,2.85,94516,2422,2004,2241,181
2020-02-24,336883,JANOEO,2.87,96253,1737,1435,1605,132
2020-02-25,336883,JANOEO,2.88,97915,1662,1455,1578,84
2020-02-26,336883,JANOEO,0,99465,1550,1327,1457,93
2020-02-27,336883,JANOEO,3.85,101012,1547,1333,1448,99
2020-02-28,336883,JANOEO,3.89,102590,1578,1379,1491,87
2020-02-29,336883,JANOEO,0,105125,2535,2129,2388,147
2020-03-01,336883,JANOEO,0,107571,2447,2093,2282,165
2020-03-02,336883,JANOEO,2.59,109380,1809,1506,1672,137
2020-03-03,336883,JANOEO,2.57,111600,2220,1889,2073,147
2020-03-04,336883,JANOEO,2.58,113551,1951,1727,1814,137
2020-03-05,336883,JANOEO,2.58,115370,1819,1578,1692,127
2020-03-06,336883,JANOEO,2.59,117287,1917,1667,1798,119
2020-03-07,336883,JANOEO,2.6,120490,3203,2683,3022,181
2020-03-08,336883,JANOEO,2.62,123990,3500,2899,3271,229
2020-03-09,336883,JANOEO,2.65,126134,2144,1828,2028,116
2020-03-10,336883,JANOEO,2.65,128023,1889,1606,1742,147
2020-03-11,336883,JANOEO,2.65,129733,1710,1481,1607,103
2020-03-12,336883,JANOEO,2.65,131819,2086,1775,1939,147
2020-03-13,336883,JANOEO,2.65,134059,2240,1912,2108,132
2020-03-14,336883,JANOEO,2.65,137198,3139,2656,2950,189
2020-03-15,336883,JANOEO,2.67,140347,3149,2646,2903,246
2020-03-16,336883,JANOEO,2.68,143042,2695,2266,2467,228
2020-03-17,336883,JANOEO,2.7,145701,2659,2214,2426,233
2020-03-18,336883,JANOEO,2.72,148247,2546,2140,2347,199
2020-03-19,336883,JANOEO,2.72,150757,2510,2084,2349,161
2020-03-20,336883,JANOEO,2.73,153676,2919,2335,2640,279
2020-03-21,336883,JANOEO,2.74,156960,3284,2648,3030,254
2020-03-22,336883,JANOEO,2.75,160023,3063,2453,2813,250
2020-03-23,336883,JANOEO,2.77,162917,2894,2330,2669,225
2020-03-24,336883,JANOEO,2.77,165689,2772,2251,2521,251
2020-03-25,336883,JANOEO,2.79,168152,2463,2074,2268,195
2020-03-26,336883,JANOEO,2.8,170683,2531,2091,2322,209
2020-03-27,336883,JANOEO,2.81,173187,2504,2043,2263,241
2020-03-28,336883,JANOEO,2.83,176327,3140,2474,2884,256
2020-03-29,336883,JANOEO,2.85,179603,3276,2630,2988,288
2020-03-30,336883,JANOEO,2.87,182495,2892,2356,2638,254
2020-03-31,336883,JANOEO,2.89,183891,1396,1131,1225,171
2020-04-01,336883,JANOEO,3.94,185232,1341,1077,1189,152
2020-04-02,336883,JANOEO,3.93,186414,1182,988,1034,148
2020-04-03,336883,JANOEO,3.92,187508,1094,877,921,173
2020-04-04,336883,JANOEO,3.89,189025,1517,1215,1331,186
2020-04-05,336883,JANOEO,3.88,190206,1181,953,1031,150
2020-04-06,336883,JANOEO,3.87,191231,1025,794,893,132
2020-04-07,336883,JANOEO,3.85,192044,813,658,706,107
2020-04-08,336883,JANOEO,3.83,192853,809,654,661,148
2020-04-09,336883,JANOEO,3.8,193655,802,673,703,99
2020-04-10,336883,JANOEO,3.78,194523,868,693,753,115
2020-04-11,336883,JANOEO,3.76,195316,793,630,674,119
2020-04-12,336883,JANOEO,3.73,195996,680,554,576,104
2020-04-13,336883,JANOEO,3.71,197144,1148,936,971,177
2020-04-14,336883,JANOEO,3.71,198240,1096,872,947,149
2020-04-15,336883,JANOEO,3.69,199213,973,795,843,130
2020-04-16,336883,JANOEO,3.66,199937,724,611,624,100
2020-04-17,336883,JANOEO,3.62,200792,855,706,742,113
2020-04-18,336883,JANOEO,0,201656,864,697,759,105
2020-04-19,336883,JANOEO,3.85,202469,813,664,706,107
2020-04-20,336883,JANOEO,3.82,203148,679,556,587,92
2020-04-21,336883,JANOEO,3.79,203728,580,478,483,97
2020-04-22,336883,JANOEO,3.76,204336,608,497,514,94
2020-04-23,336883,JANOEO,3.72,204881,545,462,462,83
2020-04-24,336883,JANOEO,3.7,205396,515,432,451,64
2020-04-25,336883,JANOEO,4.49,206087,691,568,584,107
2020-04-26,336883,JANOEO,4.45,206686,599,513,526,73
2020-04-27,336883,JANOEO,4.4,207234,548,468,474,74
2020-04-28,336883,JANOEO,4.35,207839,605,512,534,71
2020-04-29,336883,JANOEO,4.29,208287,448,373,374,74
2020-04-30,336883,JANOEO,4.24,208767,480,405,424,56
2020-05-01,336883,JANOEO,3.25,209325,557,452,452,105
2020-05-02,336883,JANOEO,0,210023,698,545,552,146
2020-05-03,336883,JANOEO,3.19,210631,608,524,488,120
2020-05-04,336883,JANOEO,3.17,211115,484,426,396,88
2020-05-05,336883,JANOEO,3.16,211562,447,387,348,99
2020-05-06,336883,JANOEO,3.14,212023,461,392,393,68
2020-05-07,336883,JANOEO,3.12,212472,449,378,384,65
2020-05-08,336883,JANOEO,3.11,212911,439,370,366,73
2020-05-09,336883,JANOEO,3.1,213372,461,391,378,83
2020-05-10,336883,JANOEO,3.08,213767,395,332,326,69
2020-05-11,336883,JANOEO,3.07,214185,418,355,342,76
2020-05-12,336883,JANOEO,3.06,214570,385,335,318,67
2020-05-13,336883,JANOEO,3.05,215003,433,335,348,85
2020-05-14,336883,JANOEO,3.05,215363,360,306,305,55
2020-05-15,336883,JANOEO,3.03,215724,361,296,296,65
2020-05-16,336883,JANOEO,3.01,216058,334,278,284,50
2020-05-17,336883,JANOEO,3,216364,306,256,252,54
2020-05-18,336883,JANOEO,2.99,216642,278,241,238,40
2020-05-19,336883,JANOEO,2.98,216895,253,227,211,42
2020-05-20,336883,JANOEO,2.97,217148,253,227,220,33
2020-05-21,336883,JANOEO,2.96,217387,239,204,197,42
2020-05-22,336883,JANOEO,2.95,217813,426,390,209,217
2020-05-23,336883,JANOEO,0,218290,477,423,259,218
2020-05-24,336883,JANOEO,3.39,218748,458,406,221,237
2020-05-25,336883,JANOEO,3.42,219143,395,345,235,160
2020-05-26,336883,JANOEO,3.47,219471,328,281,179,149
2020-05-27,336883,JANOEO,3.48,219786,315,291,161,154
2020-05-28,336883,JANOEO,3.51,220103,317,272,165,152
2020-05-29,336883,JANOEO,3.53,220410,307,275,183,124
2020-05-30,336883,JANOEO,3.53,220695,285,254,167,118
2020-05-31,336883,JANOEO,0,221003,308,279,208,100
2020-06-01,336883,JANOEO,3.08,221208,206,190,130,76
2020-06-02,336883,JANOEO,2.94,221437,229,208,137,92
2020-06-03,336883,JANOEO,3.07,221669,232,212,159,73
2020-06-04,336883,JANOEO,3.07,221883,214,193,145,69
2020-06-05,336883,JANOEO,3.07,222064,181,165,137,44
2020-06-06,336883,JANOEO,3.07,222320,256,232,186,70
2020-06-07,336883,JANOEO,3.09,222588,268,241,194,74
2020-06-08,336883,JANOEO,3.09,222827,239,212,172,67
2020-06-09,336883,JANOEO,3.1,223120,293,258,189,104
2020-06-10,336883,JANOEO,3.12,223416,296,253,199,97
2020-06-11,336883,JANOEO,3.14,223691,275,241,212,63
2020-06-12,336883,JANOEO,3.15,223944,253,226,188,65
2020-06-13,336883,JANOEO,3.17,224172,228,197,156,72
2020-06-14,336883,JANOEO,3.18,224401,229,203,156,73
2020-06-15,336883,JANOEO,3.2,224651,250,226,161,89
2020-06-16,336883,JANOEO,3.21,224880,229,199,164,65
2020-06-17,336883,JANOEO,3.23,225051,171,164,112,59
2020-06-18,336883,JANOEO,3.24,225263,212,194,166,46
2020-06-19,336883,JANOEO,3.25,225430,167,153,110,57
2020-06-20,336883,JANOEO,0,225615,185,169,135,50
2020-06-21,336883,JANOEO,3.6,225820,205,182,134,71
2020-06-22,336883,JANOEO,3.62,225978,158,132,109,49
2020-06-23,336883,JANOEO,3.57,226137,159,138,113,46
2020-06-24,336883,JANOEO,3.54,226307,170,152,115,55
2020-06-25,336883,JANOEO,3.5,226458,151,134,108,43
2020-06-26,336883,JANOEO,0,226628,170,132,103,67
2020-06-27,336883,JANOEO,4.31,226846,218,197,174,44
2020-06-28,336883,JANOEO,4.28,227081,235,201,161,74
2020-06-29,336883,JANOEO,4.26,227300,219,171,126,93
2020-06-30,336883,JANOEO,4.25,227551,251,164,103,148
2020-07-01,336883,JANOEO,2.38,227751,200,179,126,74
2020-07-02,336883,JANOEO,2.38,227927,176,163,124,52
2020-07-03,336883,JANOEO,0,228089,162,148,101,61
2020-07-04,336883,JANOEO,2.45,228247,158,146,112,46
2020-07-05,336883,JANOEO,2.44,228425,178,156,128,50
2020-07-06,336883,JANOEO,2.44,228591,166,145,111,55
2020-07-07,336883,JANOEO,2.44,228766,175,153,122,53
2020-07-08,336883,JANOEO,0,228918,152,131,104,48
2020-07-09,336883,JANOEO,2.53,229094,176,150,132,44
2020-07-10,336883,JANOEO,2.52,229271,177,150,123,54
2020-07-11,336883,JANOEO,2.51,229416,145,131,106,39
2020-07-12,336883,JANOEO,0,229629,213,197,132,81
2020-07-13,336883,JANOEO,2.62,229829,200,182,125,75
2020-07-14,336883,JANOEO,2.62,230040,211,180,137,74
2020-07-15,336883,JANOEO,2.62,230205,165,149,102,63
2020-07-16,336883,JANOEO,2.41,230364,159,140,103,56
2020-07-17,336883,JANOEO,2.4,230544,180,155,129,51
2020-07-18,336883,JANOEO,0,230742,198,181,106,92
2020-07-19,336883,JANOEO,2.58,230967,225,176,138,87
2020-07-20,336883,JANOEO,2.58,231105,138,127,82,56
2020-07-21,336883,JANOEO,2.57,231297,192,155,143,49
2020-07-22,336883,JANOEO,2.57,231437,140,130,104,36
2020-07-23,336883,JANOEO,2.56,231579,142,128,99,43
2020-07-24,336883,JANOEO,2.55,231728,149,135,103,46
2020-07-25,336883,JANOEO,2.55,231907,179,149,102,77
2020-07-26,336883,JANOEO,2.55,232088,181,163,113,68
2020-07-27,336883,JANOEO,2.55,232265,177,160,116,61
2020-07-28,336883,JANOEO,2.55,232445,180,158,127,53
2020-07-29,336883,JANOEO,2.55,232618,173,157,117,56
2020-07-30,336883,JANOEO,2.54,232780,162,142,118,44
2020-07-31,336883,JANOEO,2.53,232926,146,134,107,39
2020-08-01,336883,JANOEO,2.12,233130,204,176,119,85
2020-08-02,336883,JANOEO,0,233341,211,183,147,64
2020-08-03,336883,JANOEO,2.09,233515,174,156,122,52
2020-08-04,336883,JANOEO,2.08,233653,138,114,87,51
2020-08-05,336883,JANOEO,0,233774,121,114,87,34
2020-08-06,336883,JANOEO,2.15,233894,120,108,88,32
2020-08-07,336883,JANOEO,2.15,234014,120,112,85,35
2020-08-08,336883,JANOEO,0,234153,139,119,105,34
2020-08-09,336883,JANOEO,2.23,234277,124,120,96,28
2020-08-10,336883,JANOEO,2.23,234332,55,51,31,24
2020-08-11,336883,JANOEO,2.22,234534,202,190,7,195
2020-08-12,336883,JANOEO,0,234719,185,175,36,149
2020-08-13,336883,JANOEO,2.38,234945,226,192,90,136
2020-08-14,336883,JANOEO,2.39,235124,179,167,82,97
2020-08-15,336883,JANOEO,2.39,235308,184,172,82,102
2020-08-16,336883,JANOEO,2.4,235506,198,167,112,86
2020-08-17,336883,JANOEO,2.4,235672,166,156,75,91
2020-08-18,336883,JANOEO,2.4,235819,147,136,79,68
2020-08-19,336883,JANOEO,2.4,235986,167,151,83,84
2020-08-20,336883,JANOEO,2.4,236137,151,136,88,63
2020-08-21,336883,JANOEO,2.4,236259,122,111,59,63
2020-08-22,336883,JANOEO,2.41,236387,128,119,77,51
2020-08-23,336883,JANOEO,2.41,236552,165,149,97,68
2020-08-24,336883,JANOEO,0,236696,144,138,76,68
2020-08-25,336883,JANOEO,2.76,236834,138,127,83,55
2020-08-26,336883,JANOEO,2.76,236956,122,111,71,51
2020-08-27,336883,JANOEO,2.75,237050,94,87,45,49
2020-08-28,336883,JANOEO,2.75,237167,117,110,68,49
2020-08-29,336883,JANOEO,2.74,237304,137,112,83,54
2020-08-30,336883,JANOEO,2.75,237421,117,101,74,43
2020-08-31,336883,JANOEO,2.74,237521,100,94,59,41
2020-09-01,336883,JANOEO,1.97,237616,95,83,49,46
